0000000000000000000000000000000000000000
0000000000000000000000000000000000000000
0000000000000000000000000000000000000000
0000000001111111111111001111111111111111
0000000111000000000000000001000000000000
0000001111000000000000000011000000000000
0010011111111111111111111111111111111111
1111111111111111111111111111111111111111