000000000000000000000000000000000000000000000000000000000000000000000000011
100000000000000000000000000000000000000000000000000000000000000000000000011
100000000000000000000000000000000000000000000000000000000000000000000000011
100000000010000000000000000001111111100000000001111100111111100000000000011
100000001110000000000000000011000000000000000011111100111111111100000000011
100000011110000000000000000110000000000000000111111100111111111111111110011
111111111111111111111111111111111111111111111111111111111111111111111110011
100000000000000000000000000000000000000000000000000000000000000000000000011
100000000000000000000011100000000000000000000000000000000000000000000010011
100000000000000000000000000111000000000000000111000000111000000000000001011
101110001110001110001110000000000000000000000000000000000000000000000100011
100000000000000000000000001110000000000000000000011100000000000000000010011
101111001111000000000000000000000000000000000000000000000000000011111001011
101111100000000011111111000111111001111111111100011111111110000011111100011
101111110000000000000000000000000011111111111110000000000000000111111110011
111111111111111111111111111111111111111111111111111111111111111111111111111