0000000000000000000000000000000000000000
1000000000000000000000000000000000000000
1000000000000000000000000000000000000100
1000000000000111111111111111111111111111
1000010111000000000000000001000000000000
1000101111000000000000000011000000000000
1010011111111111111111111111111111111111000000000000000000
11111111111111111111111111111111111111111111111111111111111