0000000000000000000000000000000000000000
0000000000000000002222222222220000000000
0000000000000000000000000000000000000000
0000000000000000000000001111111111111111
0000000111000000000000000001000000000000
0000001111000000000000000011000000000000
0010011111111111111111111111111111111111000000000000000000
11111111111111111111111111111111111111111111111111111111111