00000000000000000000000000
00000000001000000011110000
00000000111000000000000000
00000000000000000000000000
00000010000000100000000000
11111111111111111111111111